12:12
18 18 18 18 18 18 18 18 18 18 18 18
18 18 18 18 18 18 18 18 18 18 18 18
18 18 18 18 18 18 18 18 18 18 18 18
18 0 0 6 0 0 0 0 185 18 18 18
18 0 0 0 0 0 0 2 0 0 0 0
18 8 0 6 0 0 18 18 18 0 6 0
18 0 0 0 0 18 18 18 18 0 0 0
18 18 18 18 18 18 18 18 18 18 18 18
18 18 18 18 18 18 18 18 18 18 18 18
18 18 18 18 18 18 18 18 18 18 18 18
18 18 18 18 18 18 18 18 18 18 18 18
18 18 18 18 18 18 18 18 18 18 18 18