12:12
0 0 0 0 0 0 0 0 0 0 0 0
0 0 0 0 0 0 0 0 0 0 0 0
18 4 18 18 0 0 0 0 0 0 0 0
0 0 0 18 0 0 0 18 0 0 0 0
0 53 18 4 4 4 4 4 18 0 0 0
0 0 18 0 0 0 0 0 18 0 0 41
0 0 18 4 4 4 4 4 18 18 18 18
0 8 18 18 0 0 0 18 18 6 0 18
18 18 18 18 0 0 0 18 18 0 0 18
18 18 18 18 0 0 0 18 18 18 18 18
0 0 0 0 0 0 0 0 0 0 0 0
0 0 37 69 2 137 137 2 69 37 0 0