12:12
222222222222
022222220000
022222222220
222222222200
222222222200
000000000000
000000000000
000000000000
000000000000
000090000000
000800000000
000000000000