12:12
18 18 18 18 18 18 18 18 18 18 18 18
18 18 0 18 0 18 0 0 18 0 17 18
18 0 0 0 0 0 0 4 0 6 0 18
18 18 0 2 0 2 0 0 18 18 18 18
18 0 6 0 0 0 6 18 2 2 2 2
18 18 0 2 0 2 0 18 2 53 0 0
18 0 0 0 6 0 0 18 2 0 137 0
18 18 0 0 2 0 2 18 2 0 0 0
18 18 18 0 0 0 0 18 2 2 0 2
53 0 37 4 0 0 0 18 2 0 0 0
0 137 0 18 0 0 18 18 2 0 137 0
0 0 0 18 18 18 18 18 2 0 0 0