12:12
18 18 18 18 18 0 0 0 0 0 0 0
18 18 18 18 18 0 2 0 6 0 2 0
0 0 0 0 2 0 0 4 2 0 0 0
21 0 0 0 2 0 2 0 0 0 2 0
0 0 0 0 2 0 0 0 2 0 0 0
18 0 0 0 0 0 2 0 0 4 2 0
153 0 0 0 2 0 0 6 2 0 0 1
18 0 0 0 0 0 2 0 0 0 2 0
0 0 0 0 2 0 0 4 2 0 0 0
53 53 0 0 2 0 2 0 0 0 2 0
18 18 18 18 2 0 0 0 2 4 0 0
18 18 18 18 18 0 2 0 6 0 2 0