12:12
0 6 0 0 0 0 0 0 0 0 18 53
0 0 0 0 0 0 0 0 0 0 0 0
0 18 18 0 18 0 18 18 18 18 0 0
0 0 6 0 18 0 18 0 57 18 0 0
0 0 0 0 18 0 18 0 0 18 0 0
18 18 18 18 18 0 18 0 0 18 0 153
73 37 0 0 0 8 0 0 0 18 18 18
18 18 18 18 18 0 18 18 2 18 18 18
0 0 0 0 18 0 18 2 2 2 18 18
0 0 4 0 4 0 18 18 2 18 18 18
0 2 4 0 4 0 18 18 2 18 18 18
85 2 4 0 4 0 18 18 2 18 18 18