12:12
18 18 18 18 18 18 18 18 18 18 18 18
18 6 0 0 8 0 0 18 0 0 0 18
18 0 0 0 0 0 6 18 0 18 0 18
18 18 18 0 0 18 18 18 0 18 0 18
0 0 0 4 4 0 0 0 0 18 0 41
0 0 0 0 0 0 0 0 0 18 18 18
0 0 0 0 18 18 18 18 18 18 18 18
0 18 0 18 0 0 0 18 18 18 18 18
0 18 0 18 0 0 0 18 0 0 0 0
0 18 0 0 0 2 0 4 0 18 0 137
0 18 18 18 0 2 0 4 0 18 18 18
9 0 0 0 0 2 0 4 0 18 18 18