12:12
2 2 2 2 2 2 2 2 2 2 2 2
2 2 3 0 0 0 0 0 0 0 2 2
2 2 2 2 2 2 2 2 0 0 2 2
2 0 0 0 0 0 0 0 0 0 2 2
2 0 0 2 2 2 2 2 2 2 2 2
2 0 0 0 0 0 0 0 0 0 0 2
2 0 0 0 0 0 0 0 0 0 0 2
2 2 0 0 0 0 0 0 0 85 2 2
2 2 2 0 0 0 0 0 85 2 2 2
2 2 2 2 0 0 0 0 2 2 2 2
2 2 2 2 0 0 0 0 2 2 2 2
2 2 2 2 2 153 153 2 2 2 2 2