12:12
2 2 2 2 2 2 2 2 2 2 2 2
2 0 3 0 0 0 0 0 0 0 0 2
2 0 0 0 0 0 0 0 4 0 0 2
2 2 2 2 2 2 2 2 0 2 2 2
18 53 0 0 0 0 0 0 0 2 2 2
18 0 0 0 0 0 0 0 2 0 0 8
18 18 18 4 4 0 0 0 2 0 153 0
18 18 18 18 4 4 0 0 2 0 0 0
6 0 0 0 0 18 0 0 0 2 2 2
0 0 6 0 0 18 18 0 0 0 0 0
0 0 0 0 0 18 18 18 0 0 153 0
25 0 0 0 6 18 18 18 18 0 0 0