12:12
2 2 2 2 2 2 18 18 18 18 18 85
2 3 0 0 0 0 0 0 0 0 18 4
2 0 0 0 2 18 0 0 18 0 0 0
2 2 2 2 2 18 53 0 0 0 0 18
0 0 0 0 18 18 53 0 18 0 0 0
169 0 0 2 0 18 18 0 0 0 0 18
2 0 2 0 0 18 18 0 0 18 0 0
2 2 0 0 0 8 18 18 0 0 0 18
0 0 4 2 2 2 2 18 18 0 0 0
0 2 0 2 53 53 21 21 18 18 0 153
0 2 2 2 0 0 0 0 0 18 18 18
153 0 0 0 0 0 0 0 0 0 18 18